1111111111111111
10PEC00000000001
10C0000000000001
1111111111111111
